1111111111111111111111111111111111111111111111111111111111111111
1100000000000000000000011111111111111100000000000000001111111111
1111111110000000000000000000011111111110000000000000000001111111
0000000000000000000000000000000000000000000000000000000000000001
1111111000000000000001111111111100000000001111111111111111111111
1111100000000000011111111111111111111001111111000000000001111111
1111111110001111111111111111111111111001111111111111100111111111
1111000000000000111111111111111111100000000001111111111111111111
1111000000000000000000000000000000000000000000000000000000000001
1111111111111111111111111111111111111111111111111111111111111111
1111111111111111111111111111111111111111111111111111111111111111
1111111111111111111111111111111111111111111111111111111111111111
1111111111111111111111111111111111111111111111111111111111111111
1111111111111111111111111111111111111111111111111111111111111111
1111111111111111111111111111111111111111111111111111111111111111
1111111111111111111111111111111111111111111111111111111111111111
1111111111111111111111111111111111111111111111111111111111111111
1111111111111111111111111111111111111111111111111111111111111111
1111111111111111111111111111111111111111111111111111111111111111
